何・なに	mikä?	kokonaisuus1
何年生・なんねんせい	moneskoluokkalainen?	kokonaisuus1
年・とし	vuosi	kokonaisuus1
二年生・にねんせい	2. luokkalainen	kokonaisuus1
生年月日・せいねんがっぴ	syntymäaika	kokonaisuus1
先生、せんせい	opettaja	kokonaisuus1
生きる・いきる	elää	kokonaisuus1
生まれ・うまれ	syntynyt	kokonaisuus1
日本人・にほんじん	japanilainen	kokonaisuus1
何人・なんにん	kuinka monta henkilöä	kokonaisuus1
人・ひと	ihminen	kokonaisuus1
日本・にほん・にっぽん	Japani	kokonaisuus1
日・ひ	aurinko	kokonaisuus1
本・ほん	kirja	kokonaisuus1
本当・ほんとう	tosi	kokonaisuus1
大きい・おおきい	iso	kokonaisuus1
大学・だいがく	yliopisto	kokonaisuus1
小さい・ちいさい	pieni	kokonaisuus1
大中小・だいちゅうしょう	suuri, keskikokoinen, pieni (esim. annoskoko)	kokonaisuus1
中・なか	keskellä; sisällä	kokonaisuus1
中学生・ちゅうがくせい	yläkoululainen	kokonaisuus1
時・とき	aika	kokonaisuus1
時・じ	tunti	kokonaisuus1
分・ぶん、ふん、ぷん	minuutti	kokonaisuus1
分かる・わかる	ymmärtää	kokonaisuus1
月・つき	kuu	kokonaisuus1
月・がつ	kuukausi	kokonaisuus1
二か月・にかげつ	kahden kuukauden aika	kokonaisuus1
古い・ふるい	vanha	kokonaisuus2
中古・ちゅうこ	käytetty	kokonaisuus2
新しい・あたらしい	uusi	kokonaisuus2
新年・しんねん	uusivuosi	kokonaisuus2
明日・あした	huominen	kokonaisuus2
明るい・あかるい	kirkas, valoisa; iloinen	kokonaisuus2
音・おと	ääni	kokonaisuus2
音楽・おんがく	musiikki	kokonaisuus2
暗い・くらい	pimeä; synkkä	kokonaisuus2
暗記する・あんきする	opetella ulkoa	kokonaisuus2
楽しい・たのしい	kiinnostava; hauska, mukava	kokonaisuus2
女・おんな	nainen	kokonaisuus2
女の子・おんなのこ	tyttö	kokonaisuus2
男女・だんじょ	miehet ja naiset	kokonaisuus2
女性・じょせい	naishenkilö, naispuolinen	kokonaisuus2
子ども・こども	lapsi	kokonaisuus2
男子・だんし	poika	kokonaisuus2
女子・じょし	tyttö	kokonaisuus2
好き・すき	pitää jostakin, mieluinen	kokonaisuus2
大好き・だいすき	pitää paljon jstkin, rakastaa, erittäin mieluinen	kokonaisuus2
お好み焼き・おこのみやき	okonomiyaki (japanilainen ruokalaji)	kokonaisuus2
男・おとこ	mies	kokonaisuus2
男の子・おとこのこ	poika	kokonaisuus2
男性・だんせい	mieshenkilö, miespuolinen	kokonaisuus2
口・くち	suu	kokonaisuus2
人口・じんこう	väkiluku	kokonaisuus2
目・め	silmä	kokonaisuus2
目的・もくてき	päämäärä, tavoite; aie, tarkoitus	kokonaisuus2
科目・かもく	kouluaine	kokonaisuus2
手・て	käsi	kokonaisuus2
上手・じょうず	hyvä jossakin	kokonaisuus2
下手・へた	huono jossakin	kokonaisuus2
上・うえ	yläpuoli, ylä-	kokonaisuus2
年上・としうえ	vanhempi (ihminen)	kokonaisuus2
上がる・あがる	nousta	kokonaisuus2
上げる・あげる	nostaa	kokonaisuus2
下・した	alapuoli, ala-	kokonaisuus2
年下・としした	nuorempi (ihminen)	kokonaisuus2
下がる・さがる	aleta?	kokonaisuus2
下げる・さげる　下さい・ください	laskea alas     saisinko	kokonaisuus2
白い・しろい	valkoinen	kokonaisuus2
白黒・しろくろ	mustavalkoinen	kokonaisuus2
黒い・くろい	musta	kokonaisuus2
黒板・こくばん	liitutaulu	kokonaisuus2
色・いろ	väri	kokonaisuus2
何色・なにいろ	minkä värinen?	kokonaisuus2
百・ひゃく	sata	kokonaisuus2
千・せん	tuhat	kokonaisuus2
万・まん	10 000	kokonaisuus2
円・えん	jeni	kokonaisuus2
何円・なんえん	montako jeniä?	kokonaisuus2
水・みず	(kylmä) vesi	kokonaisuus2
水よう日・すいようび	keskiviikko	kokonaisuus2
魚・さかな	kala	kokonaisuus2
金魚	kultakala	kokonaisuus2
こざかな　	syötävä pikkukala	kokonaisuus2
ちぎょ		kokonaisuus2
肉・にく	liha	kokonaisuus2
魚肉・ぎょにく	kalan liha	kokonaisuus2
牛・うし	lehmä, härkä, nauta	kokonaisuus2
牛肉・ぎゅうにく	naudanliha	kokonaisuus2
牛乳・ぎゅうにゅう	lehmänmaito	kokonaisuus2
出る・でる	mennä ulos, tulla ulos	kokonaisuus2
出す・だす	ottaa ulos	kokonaisuus2
出口・でぐち	uloskäynti	kokonaisuus2
入る・はいる	mennä sisään, tulla sisään	kokonaisuus2
入れる・いれる	laittaa sisään	kokonaisuus2
入口・いりぐち	sisäänkäynti	kokonaisuus2
新聞		kokonaisuus3
お先にしつれいします。		kokonaisuus3
前・まえ		kokonaisuus3
下名前・したなまえ		kokonaisuus3
来る・くる		kokonaisuus3
来月・らいげつ		kokonaisuus3
気分		kokonaisuus4
時間・じかん		kokonaisuus4
